6 10
##########
## ## ##  
#        #
# #### ###
     #   #
##########